13
6
+ + + + + + - - + + + + +
- - + + + + + + + + + + O
+ + + - - + + + + + + + +
+ + + - - - + + + + + + +
+ + + + + + + + + + + + +
O + + + + + + + + + + + +